1010
0010000101
0111000111
1010011111
1001001011
0010101011
1000011011
0001100101
0000101101
1000111001
0101010001

0100011100
1100111000
0011100000
0110010010
1011101110
0111010000
1101001011
0111100010
1010000111
1111111111
